..........
.o........
..........
......o...
..o.......
.......o..
